+-+-+-+-+-+-+-+-+-+-+-+-+-+-+-+-+
|                               |
+ + + + + + + + + + + + + + + + +
|                               |
+ + + + + + + + + + + + + + + + +
|                               |
+ + + + + + + + + + + + + + + + +
|                               |
+ + + + + + + + + + + + + + + + +
|                               |
+ + + + + + + + + + + + + + + + +
|                               |
+ + + + + + + + + + + + + + + + +
|                               |
+ + + + + + + + + + + + + + + + +
|                               |
+ + + + + + + + + + + + + + + + +
|                               |
+ + + + + + + + + + + + + + + + +
|                               |
+ + + + + + + + + + + + + + + + +
|                               |
+ + + + + + + + + + + + + + + + +
|                               |
+ + + + + + + + + + + + + + + + +
|                               |
+ + + + + + + + + + + + + + + + +
|                               |
+ + + + + + + + + + + + + + + + +
|                               |
+ + + + + + + + + + + + + + + + +
| |                             |
+-+-+-+-+-+-+-+-+-+-+-+-+-+-+-+-+

